####################
## - .             #
# .  -  #######++-+#
#########  .  +    #
#      # +|-||+    #
# @  |-   .|  +++-+#
#  +|- # + +  + - .#
#      # -    +    #
####################
