####################
#                  #
#                  #
#                  #
#     .            #
#        @         #
#                  #
#                  #
####################
