####################
#                  #
#                  #
#                  #
#                  #
#        @         #
#                  #
#                  #
####################
