################
#    -         #
#   #########|##
#   #   -   #  #
#   # - # @ #  #
#  -.   #   # .#
#############| #
#  +   #   #   #
# .+   .|. +   #
#  +     #  #  #
################
