################
#  .       -   #
#   #########|##
# - #   -   #  #
#   # - # @ # .#
#  -.   #   #  #
#############| #
# +   #   #    #
#.+    |. +    #
# +     #  #   #
################
