################
#    -         #
#  ##########|##
#   . #     # .#
#   #   # @ #  #
#   #       # .#
################
